11111111111111111111
11111111111111111111
11111666666661111111
11111032323001111111
11111000330001111111
11111000000001111111
11100000000000011111
11100000000000011111
11100000000000011111
11100000000000011111
11100000011111111111
11100000011111111111
11100000011111111111
11100000000000011111
11100234323400011111
11100000000000011111
11111111100000011111
11111111100000011111
11111111100050011111
11111111100444011111
11100000000333011111
11100000000222011111
11100000000000011111
11103420000000011111
11104230011111111111
11102340011111111111
11100000011111111111
11100000000000011111
11100000000200011111
11100000000030011111
11111111100004011111
11111111100005011111
11111111100004011111
11111111100030011111
11100000000200011111
11100000000000011111
11100000000000011111
11100000000000011111
11100000011111111111
11100200011111111111
11100000011111111111
11100000000030011111
11100030000000011111
11100000000000011111
11111111100000011111
11111111100020011111
11111111100555011111
11111111100090011111
11111111111111111111
11111111111111111111